NO wall.xpm
SO wall.xpm
WE wall.xpm
EA wall.xpm

F 0,0,0
C 225,30,0

        1111111111111111111111111
        1000000000000000000000001
        10110N0000000000000000001
        1011000000000000000000001
111111111011000000000000000000001
100000000011000000000000000000001
100001110111111111010000000011111
10000111111111111100000000001
11000111111111111100000000001
10000000000000000000000000001
10000000000000000000000000001
1100000111000001111101111000111
11110111 1000001  1101111000001
11111111 1111111  1111111111111
